ひそか に (hisoka ni): Thầm lặng, bí mật
こっそり (kossori): Lén lút, vụng trộm
おのずと (onozuto): Tự nhiên, đương nhiên
急遽 (kyuukyo): Vội vàng, khẩn cấp
しきりに (shikirini): Liên tục, không ngừng
総じて (soujite): Nói chung, nhìn chung
無性に (mushou ni): Vô cùng, cực kỳ
じめじめ (jimejime): Ẩm ướt, nhớp nháp
あらかじめ (arakajime): Trước, sẵn
事前 に (jizen ni): Trước, trước khi
おおむね (oomune): Đại khái, khoảng chừng
とりわけ (toriwake): Đặc biệt, nhất là
くまなく (kumanaku): Khắp nơi, mọi ngóc ngách
ふい に (fui ni): Bất ngờ, đột ngột
大げさ に (oogesa ni): Phóng đại, làm quá
もはや (mohaya): Đã, rồi
頻繁 に (hinpan ni): Thường xuyên, hay
へたへた に (hetaheta ni): Mệt mỏi rã rời, kiệt sức
かろうじて (karoujite): Vừa đủ, suýt soát
何とか (nantoka): Bằng cách nào đó, xoay sở
すんなり (sunnari): Trơn tru, suôn sẻ
かねがね (kanegane): Từ trước, đã lâu
以前 から (izen kara): Từ trước, trước đây
故意 に (koi ni): Cố ý, có chủ tâm
わざと (wazato): Cố ý, cố tình
もっぱら (moppara): Chủ yếu, hầu hết
うすうす (usuusu): Lờ mờ, mơ hồ
なんとなく (nantonaku): Không hiểu sao, một cách mơ hồ
いとも (itomo): Dễ dàng, đơn giản
若干 (jakkan): Một chút, hơi
わずか に (wazuka ni): Một chút, rất ít
真っ先 に (massaki ni): Đầu tiên, trước hết
がらり と (garari to): Hoàn toàn thay đổi, đột ngột
漠然 (bakuzen): Mơ hồ, không rõ ràng
せかせか と (sekaseka to): Vội vã, hấp tấp
めいめい に (meimei ni): Mỗi người, riêng rẽ
ありあり と (ariari to): Rõ ràng, rành rành
ひしひし と (hishihishi to): Cảm nhận rõ ràng, thấm thía
ずっしり と (zusshiri to): Nặng trịch, chắc nịch
つぶさに (tsubusani): Chi tiết, tỉ mỉ
みっちり (micchiri): Chặt chẽ, kỹ lưỡng
うずうず (uzouzo): Ngứa ngáy, bồn chồn
じっと (jitto): Im lặng, đứng im
実に (jitsu ni): Thực sự, quả thực
ろくに (rokuni): Không... đàng hoàng, không... tử tế
大して (taishite): Không... lắm, không... nhiều