41. 取り戻す (Torimodosu): Lấy lại, khôi phục
42. ありふれる (Arifureru): Phổ biến, thông thường
43. うろたえる (Urotaeru): Bối rối, hoảng loạn
44. 慌てる (Awateru): Vội vàng, hấp tấp
45. 帯びる (Obiru): Mang, có dấu hiệu
46. 思い詰める (Omoitsumeru): Suy nghĩ kỹ, trăn trở
47. 尽くす (Tsukusu): Cống hiến, tận tâm
48. 切り出す (Kiridasu): Bắt đầu nói, đề cập
49. 戸惑う (Tomadou): Bối rối, lúng túng
50. 退く (Shirizoku): Rút lui, lùi bước
51. 見かける (Mikakeru): Bắt gặp, nhìn thấy
52. 染みる (Shimiru): Thấm, ngấm
53. おびえる (Obieru): Sợ hãi, khiếp sợ
54. 怖がる (Kowagaru): Sợ hãi
55. 察する (Sassuru): Đoán, suy đoán
56. 食い違う (Kuichigau): Khác biệt, mâu thuẫn
57. よみがえる (Yomigaeru): Sống lại, hồi sinh
58. たたえる (Tataeru): Khen ngợi, ca ngợi
59. 滅びる (Horobiru): Diệt vong, suy tàn
60. はじく (Hajiku): Đẩy ra, bật ra
取り消す (Torikesu): Hủy bỏ, rút lại
競い合う (Kisoiau): Cạnh tranh, thi đấu
遂げる (Togeru): Đạt được, hoàn thành
うなだれる (Unadareru): Cúi đầu, ủ rũ
なだめる (Nadameru): An ủi, xoa dịu
しくじる (Shikujiru): Thất bại, mắc lỗi
乗り出す (Noridasu): Bắt đầu, tham gia
駆けつける (Kaketsukeru): Vội vàng đến
渋る (Shiburu): Miễn cưỡng, do dự
備え付ける (Sonaetsukeru): Trang bị, lắp đặt
かさばる (Kasabaru): Cồng kềnh, chiếm chỗ
にじむ (Nijimu): Nhòe, thấm
つぶやく (Tsubuyaku): Lẩm bẩm, thì thầm
ばてる (Bateru): Mệt mỏi rã rời
交える (Majieru): Giao nhau, lẫn vào
危ぶむ (Ayabumu): Lo lắng, nghi ngờ
覆す (Kutsugaesu): Lật ngược, bác bỏ
くじける (Kujikeru): Nản lòng, thất vọng
ぼやく (Boyaku): Cằn nhằn, phàn nàn
施す (Hodokosu): Thực hiện, ban cho
になう (Ninau): Gánh vác, đảm nhận
ずれ込む (Zurekomu): Trượt, lệch
なつく (Natsuku): Quen, thân thiết